XXXXXXXXXXXXXXXXXXXX
X........X.........X
X...XX...X..XXXXX..X
X..XXXX..X....X....X
X...XX...X....X....X
X..XXXX..X....X....X
X...XX...X....X....X
X...XX...X....X....X
X...XX........X....X
X...XX...P....X....X
X...XX...X....X....X
X........X....X....X
X..XXX...X...XXX...X
X........X.........X
X........X.........X
X..XXXX..XXXXXXXX..X
X..X..X..X.....X...X
X..X..XXXX..X..X...X
X...........X......X
XXXXXXXXXXXXXXXXXXXX
